1111111111111111111111
1000000000000000000001
10E0000000000000000001
1WWWWWWWWWWWWWWWWY0001
10000000000000000Y0001
10000000000000000Y0C01
10000YWWWWWWWWWWWWWWW1
10000Y0000000000000001
10000Y0000000000000001
10000Y0000000000000001
10C00Y0000000000000001
1WWWWWWWWWWWWY00000001
1000000000000Y00000001
1000000000000Y00000001
1000000P00000Y00000001
1111111111111111111111