111111111111111111111111111111111111111
100000000000000000000000000000000000001
12E000000000000000000000000000000000001
1WWWWWWWWWWWWWWWWWWWWWWWWWWWWWWWWWWWWY1
1000000000000000000000000000000000000Y1
1000000000000000000C00000C00000000000Y1
10000YWWWWWWWWWWWWWWWWWY0000000000YWWW1
10000Y00000000000000000Y0000000000Y0001
10000Y00000000000000000Y0000000000Y0001
10000Y00000000000000000Y0000000000Y0001
10C00Y00000000000000000Y0000000000Y0001
1WWWWWWWWWWWWY000000000Y0000000000Y0001
1000000000000Y000000000Y0000000000Y0001
1000000000000Y000000000WWWWWWWWWWWW0001
1000000P00000Y0000000000000000000000001
111111111111111111111111111111111111111