11111111111111111111111111111111111111111
11111111111111111111111111111111111111111
11000000000F0F000000000000000000000000011
110E0000000000000000000000000000000000011
11WWWWWWWWWWWWWWWWY0000000000000000000011
11000000F0F0F0F0F0Y0000000000000000000011
110000000000000000Y0C00000000000000000011
110000YWWWWWWWWWWWWWWWWWWWWWWWWWWWWWWWW11
110000Y0000000000000000000000000000000011
110000Y0000000000000000000000000000000011
110000Y00000F0000000000000000000000000011
110C00Y0000000000000000000000000000000011
11WWWWWWWWWWWWY00000000000000000000000011
11000000000000Y00000000000000000000000011
1100F000000000Y000F0000000000000000000011
11000000P00000Y00000000000000000000000011
11111111111111111111111111111111111111111
11111111111111111111111111111111111111111