1111111111111111111111
10000000000000E0000001
1000000000000000000001
1000000000000000000001
1000000000000000000001
1000000000000000000C01
1000000000000000000001
1000000000000000000001
1000000000000000000001
1000000000000000000001
1000000P00000000000001
1111111111111111111111