1111111111111111111111
1000000000000000000001
1000000000000000000001
1000000000000000000001
1000000000000000000011
1111000010101001100001
1111111111110000101011
1010110000000000000001
1111111111111111111111